{"Field":[
    "wwwwwwwwwwww",
    "d000000000bw",
    "d0000000000w",
    "wcccccccccvw",
    "w0000000000w",
    "w0000000000w",
    "w0000s00000w",
    "w0000000000w",
    "w0000000000w",
    "w0000000000w",
    "wr000000000w",
    "wwwwwwwwwwww"
    ]}