{"Field":[
    "wwwwwwwwwwww",
    "w000000000bw",
    "w0000000000w",
    "w0000000000w",
    "w0000000000w",
    "d0000000000w",
    "d0000000000w",
    "w0000000000w",
    "w0000000000w",
    "w0000000000w",
    "wr000000000w",
    "wwwwwwwwwwww"
    ]}