{"Field":[
    "wwwwwwwwwwww",
    "w000000000bw",
    "w0000000000w",
    "w0000000000w",
    "w0000000000w",
    "d0000000000w",
    "d0000000000w",
    "wcccccccc00w",
    "w000c000c00w",
    "w0c0c0c0cc0w",
    "wrc000c0000w",
    "wwwwwwwwwwww"
    ]}