{"Field":[
    "wwwwwwwwwwww",
    "w000000000bw",
    "w0000000000w",
    "w0000000000w",
    "w0000000000w",
    "df000000000w",
    "df000000000w",
    "w0000000000w",
    "w0000000000w",
    "wccccccccc0w",
    "wr000000000w",
    "wwwwwwwwwwww"
    ]}